	        T73/TC55
Yazan :   Bülent ECEVİT	T$fjW
Amerika'ya 1000 yılında ayak basan gemici: Leif Ericson..
Nova Scotia: Ayrı bayrağı ohn bir Kanada Eyaleti-Fransız Askerî Gücünün yapamadığı işi bir kaç domuz nasıl başardı?
^SHpjj.'^iJHfi8S,	. *\v	} "mi\      »tfi»	j&»w
M «lit»»?	.	, \       \   :<  İlla* <ıiJlL^l -ja-	mm  i
-•-.      <W>-       OE9K       ^  ,.	/    s	\   i   »il 1HİDHİ ^	w     ı
V;	ÜÜI
;
Halifax yakınındaki Shearvrater'de bulunan Kanada  Donanması Hava  Üssüne  bağlı     «Magnificient» uçak taşıt gemisi (solda) bir manevra sırasında  bir Amerikan petrol gemisinden yakıt alıyor..
Tefrika No- 5	Giydikleri ekose kumaş,  açık	ken, Fransızlar, İngiliz Donan-
Blzl Kanada'ya götüren cKn-	^^d üstüne mavi çizgili...    Bu	ma  üssünü  Halifax'tan   atabil-
zey    Yıldızı»,    Newfoundland'ın	renkler Nova Scotia'nın bayra-	mek  için çok uğraşmış,     fakat
Gander hava alanında     kısaca	I™1»11   alınmış.      Kanada'nın,	bir   türlü   muvaffak  olamamış-
durduktan     sonra  Halifax'a   in-	kendme mahsus bir *>****& tbn	Iar-
di. Halita*,    Nova Scotia    eya-	lunan tek eya,etl »««s»-    Is"	Onların yıllarca kan    dökme
Jetinin başkenti...	koc Kraİ1 James IV. 1621 de bu-	pahasına  yapamadıklarını,   son
«Nova Scotia» yeni İskoçya de	rava serdiği bayraktan, yeni İs-	radan birkaç domuz    yapmağa
mek ama, Amerika kıtasına da-	oyalılar  hâlâ   vazgeçememiş-	muvaffak olmuş,
racık bir kara parçasiyle bağlı	,er-	1819 da yeni  amirallik bina-
bulunan bu yarımadanın    tarl-	AMİRAL FiSHERİN	sma  yerieSen      İngiliz   amirali
hi,  Iskoçyalı   göçmenlerin  gell-	DOMUZLARI	Fisher,  evinin  etrafında  çayırı
sinden çok daha geriler    ekadar   	—	bol  bulup domuz    yetiştirmeğe
uzanıyor.	Bizim   indiğimiz   Halifaz  şeh	kalkmış.  Fakat komşular buna
1000 yılında tzlanda'dan kal-	ri> Kanada'nın Atlas Okyanusu	İtiraz edince o kadar içerlemiş kıp, Eristof Kolomb'dan yüz-	kıyılarındaki en kullanışlı ta-	ki, karargâhı Nova Scotia'dan yıllarca önce Amerika kıyılan-	biî Umanlardan biri.	kaldırıp Bermuda'ya naklettir- na varmış olan Norveçli gemici	Fakat Halifax'ı 1749 da ku-	miş ve domuzlarlyle beraber Leif Ericson, belki de buraya	ran İngilizler, bu limandan ti-	oraya göç etmiş, ayak basan ilk Avrupalı... Leif	cari maksatlarla değil, askeri	Vaktiyle Amiral Fisher'in do Ericson'ım. 35 gemiciyle -gllne-	maksatlarla İstifade etmeyi.	muzlarını otlattığı geniş «sa ye doğru yaptığı bir seferde.	Fransızlara karşı kullanacakla-	yırlarda şimdi Kanada Donan- Nova Scotia'nın Kuzeyindeki	n gemileri burada üslendirmeyi	' masına ve hava kuvvetlerine Breton Burnu Adasına da çık-	düşünmüşler.	,ait sayısız bina yükseliyor: Ter tığı tahmin ediliyor.	Başlangıçta     askeri   maksat-	saneler,   hangarlar,   okul,   kışla
Üzerinde ilk koloniyi Fran-	laria kurulan Halifas, bugün hâ	ve SUDay evleri... sızların kurmuş olduğu Nova	lâ bu maksada hizmet ediyor.	Kanada donanmasının en bü Scotia, 16. yüzyıl başlarından 1-	Haliîas deniz üssü. iki dünya	yük personel yetiştirme merkezi tibaren Fransızlarla İngilizler	harbinde de, Müttefik'er'n Ku-	burada kurulmuş. Bu eğitim arasında birçok defalar el de-	zey Atlantik bö.geslndeki üstün	merkezinin başlıca görevi de ğiştirdikten sonra, 1713 de in-	lüğünde büyük rol oynamış.	nizaltılara karşı yapılacak sa- glllz idaresinde karar kılmış.	Kanada donanmasının kuru-	vaşlar için hazırlık olduğundan Fransızlar yalnız Breton Bur-	luşu, bu limanın 1907 de İngi-	hava kuvvetleriyle de işbirliği nun'da bir müddet daha tutuna	lizlerden devralınmas» başlı-	yapılıyor, bilmişler.	yor.   Şimdi   Kanada   donann^ısı-	Bneün  Kanada  Deniz ve H»
tskoçyalılar   buraya   toplu   o-	nın Atlantik Komutanlığı ami-	va Kuvvetlerinin müşterek    bir
Iarak ilk defa 1625 te gelmekle	rallik binası, bugün de Kanada	üssü olan Halifaı, bir harb çı-
beraber, asıl büyük İskoç koio-	Atlantik   Komutanlığının   ami-	karsa Kuzey Atlantik bölgesln-
nisi ancak 1749 da,    Ha!ifax'ta	rallik  binası  olarak     kullanılı-	deki     konvoyların     güvenliğini
kurulmuş.	yor.	sağlamakta belki de başlıca ro-
1951 nüfus sayımına göre No-	Bu bölge üzerinde    Fransız -	lü oynıyacak.
va Scotia'nın nüfusu    642.584...	İngiliz   çekişmesi   devam   eder-	(Devam edecek)
Yarımadanın     ilk   halkı     elan	""                        	;	      —                           	
Fransızlar   bugün   bu   nüfusun	tKKK^ğt^SItKm^HUtSHBKBMKKF'V'lBBlBf^t'VmT'BMBKKt^.- •
ancak yüzde  12 si kadar tutu-	y^|^^yyTf*Hr^^Biiıı^^Sp^^^^JMlfr»^Br^Bİ'*v
yor.  Nüfusun  yüzde 75 i  İngiliz	7 **k^%     «     I " JS f{	^> jff M                           JEtâ-'.'-'.'-
ve İskoç asıllı.	ıffllılıTMl4iıSı dimili lııı-tll!lııl»kınlîTOl»ıfllm
Bunlar arasında    özelliklerini     HWÎj^WWPffPmwffrWf^^ en çok muhafaza edebilmiş grup
İskoçlar...     Yarımadanın     bazı  »      tK	* J    O	I
yerlerinde   halk   hâlâ   iskoçya-   J ©löf i|Cİ£r I      DO £ €11*11      İTİ I lıların dilini  konuşuyor,    ekose
iskoç kumaşından erkek etekli-	Irrtl.klil.»f8.a»»2
ğl  giyiyor, İskoç dansları yapı-	KUDUI      dilarl     a
yor.
m	,	r.    	C_    1     A~\	ınnın    vot.1tia     90    aftıtctnc        triinH
