■      |      Türkiye'yi bir Menderes   ^HMH^aBH^^n^Haaa|Hj	Miktan normalin pek üstün. 1
I
            Kabinesi  İdare     ediyor.	"de olan bu değişikliklerde, i- ■
Fakat bu Kabinenin Ok sek-	IJj*-.   UauJaHaJa    L ! 4»   — '	Ieri «ürdüğümüz/her iki âmi. ||
İmden  bugün  ayaktu     yalnız	nflV   İYİ Mil fi Pl P\   fi   II İl      E"! 1	1{n de e5« o^Mt rol oynamış |
.   Bay Menderes kalmışür.	1#%İ J     I    İVİIUVI V«J    W    IIIU   İlli	olduğunu kabul edelim! O za- |
Gerçi Prof. Köprülü 4e hâ-	-          ,                        -     ..       _	man^a söyle bir hükme var- |
lâ Kabinededir ama, Kabineye	C 11**1      #14% L lif #%âr»#%l#4l* 9	»J ™™nd« kal,v«:
I   girmiş olduğu  „rada     bulun-	SllU      06I   B IV6CGKÎ11     T	Bay  Menderes'in  s.yaseti ya ■
1   mıyan yen! bir Bakanl*. (gö-	"" " M      JJ V II ■ ■ ■ J W** IW ■ ■     ■	en  yakm  mesa,  arkadaşlarına |
I   rülen lüzum üzerine kurulda-	,       .       .^.JT, .    „ »        T        s^s . «„.        .	,! £T     «•   *<>">"»*">- |
ğu bildirilmekle beraber    ab",	aykırı duştügu için deği-       Iıca sebebi Bakanların başarı-	cek bir siyasettir, ya da,    en I
„,   ,      ,,                  ,      ...	sjr.                                                      sizliği ise, o zaman    da    Bay	çok   güvenerek  seçtiği    mesai i
revleri açıklanmamı; olan dor-	"                                                               J\       '      ™" "    **"    ""/	...       .     .    ,      ,.,    .     .
^^tErst	srnr^âSrr sasriJftSr	ytr'rr^^»ı
resin katan, olduğunu söyle-	«^ c kadar çoktur W,    bn	^.^ b|Iar Demokrat Par. ■
mek yanlış olmaz.	Bakanların, Bakanlar Kurulun          Gene bu ihtimal kabul edi-	ti iktidarının başarılı bir şekil- ■
Hem  Bakanlar Kuflulu'nun,	ja çoğunlukça benimsenmiş bir      ""e- bir bakanın işinde başa-	de ımrı hiikümet edebilmesi §
Bakanlar Kurulu Başkanından	riyaseti değ», ancak Bakanlar       " gösteremediği, ancak bir ba-	|çfn. Kabinede ne kadar   Ba. |
başka «yeleri, yalnıs birer de.	Korulu  Başkanınca benimsen-       şarww1»»mni   görfilmesMe  an-	kanllk  vars, hepsini   İşgal  e- 1
fa değil, baran birkaç defa de	mi, M, g|yaser| desteklememiş       ta?ılabnece*lııe B«re,   Menderes	denlerln, bes yılda birer, iki- |
getirilmişlerdir.	olduklarına hükmetmek sorun      Kabinesi, kurr'—undan bugü-	şer yanut daha çok     defalar I
!
      Hastalık, ölüm, skandal, s!-	da kalına. O halde, 1950 mayı-      ne kadar, en az,    değiştirdiği	değiştirilmesi denenmiş, yalnız f
yad gaf gibi şartlar bir yana,	smdan bu yana ortada Mende-      bakan sayısı nisbetinde başa-	Başbakanlık mevkiindeki satın §
normal olarak bir   bakan, ya	res Kabinesinin siyaseti    diye      rısızlık   ı*östermiş  demektir.   S	deer«tirilmesl henüz denenme- 1
İsinde basan gösteremediği ya	bir şey yok, ancak Bay Men-       yıl İçinde deŞişen bakan sayı-	mistir,
da pütmek İstediği siyaset Ba-	deresin siyaseti var demektir.      susa bakılacak olursa bu nis-	Acaba bir de o denense na- §|
•   kanlar Kurulu üyelerinin  ço.	Yok eğer, Kabinede bugüne      betin de bir kabinenin düşmesini	sil olur?                                      ■
jg   ğunlugunoa benimsen mis, siya»	kadar olan değişikliklerin baş»      gerektirecek kadar yüksek ol-	Bütend ECEVİT jg
■M«ıı»ııyjsfl|^^	"™—a
